00000000000000000000
00000000000000000000
00000000000000000000
00000000000000000000
00111111111111111100
00122222000033333100
00122222000033333100
00122222000033333100
00122222000033333100
00122222000033333100
00122222000033333100
00122222000033333100
00122222000033333100
00122111000011133100
00122133000022133100
00122133000022133100
00122133000022133100
00122133000022133100
00122133000022133100
00122133000022133100
00122111000011133100
00122222000033333100
00122222000033333100
00122222000033333100
00122222000033333100
00122222000033333100
00122222000033333100
00122222000033333100
00122222000033333100
11111111000011111111