00000000000000000000
00000000000000000000
00000000000000000000
11111111111111111111
00333333333333333300
00333333333333333300
00333333333333333300
00000000000000000000
00000000000000000000
00333333333333333300
00333333333333333300
00333333333333333300
00001111100111110000
00001111100111110000
00002222222222220000
00002222222222220000
00000000000000000000
00000000000000000000
00002222222222220000
00002222222222220000
00001111100111110000
00001111100111110000
00333333333333333300
00333333333333333300
00333333333333333300
00000000000000000000
00000000000000000000
00333333333333333300
00333333333333333300
00333333333333333300
00111111000011111100