00000000000000000000
00000000000000000000
00000000000000000000
11111111111111111111
22222222222222000222
22222222222222000222
22222222222222000222
22222222222222000222
22222222222222000222
22200000000000000222
22200000000000000222
22200000000000000222
22200000000000000222
22200000000000000222
22200022222222222222
22200022222222222222
22200022222222222222
22200022222222222222
22200022222222222222
22200000000000000222
22200000000000000222
22200000000000000222
22200000000000000222
22200000000000000222
22222222222222000222
22222222222222000222
22222222222222000222
22222222222222000222
22222222222222000222
11111111111111000111