00000000000000000000
00000000000000000000
00000000000000000000
11111111111111111111
00000000000000000000
00000000000000000000
00000000000000000000
00000000000000000000
00033333333333333000
00333333333333333300
00333333333333333300
00333333333333333300
00333333333333333300
00333333333333333300
00333333333333333300
00333333333333333300
00333333333333333300
00333333333333333300
00333333333333333300
00333333333333333300
00223333333333332200
00223333333333332200
00222233333333222200
00222233333333222200
00112222222222221100
00112222222222221100
00001122222222110000
00001122222222110000
00000011111111000000
00000011111111000000