00000000000000000000
00000000000000000000
00000000000000000000
00000000000000000000
00000000000000000000
00000000000000000000
00000000000000000000
11111111111111111111
00000000000000000000
00000000000000000000
00000000000000000000
33333333333333333333
33333333000033333333
33333333000033333333
33333333000033333333
33333333000033333333
33333333000033333333
33333333000033333333
33333333000033333333
33333333000033333333
33333333000033333333
33333333000033333333
33333333000033333333
33333333000033333333
33333333000033333333
33333333000033333333
33333333000033333333
33333333000033333333
11111111333311111111