00000000000000000000
00000000000000000000
00000000000000000000
11111111111111111111
22222222222222222000
22222222222222222000
22222222222222222000
00000000000000000000
00000000000000000000
00000000000000000000
22222222222222222000
22222222222222222000
22222222222222222000
00000000000000000000
00000000000000000000
00000000000000000000
11111111111111111000
00000000000000000000
00000000000000000000
00000000000000000000
22222222222222222000
22222222222222222000
22222222222222222000
00000000000000000000
00000000000000000000
00000000000000000000
22222222222222222000
22222222222222222000
22222222222222222000
11111111111111111000