00000000000000000000
00000000000000000000
00000000000000000000
11111111111111111111
22222222222222222222
22222222222222222222
22222222222222222222
22222222222222222222
22220000000000002222
22220000000000002222
22220000000000002222
22220000000000002222
22220000000000002222
22220011333311002222
22220013333331002222
22220013333331002222
22220013333331002222
22220013333331002222
22220013333331002222
22220013333331002222
22220011111111002222
22220000000000002222
22220000000000002222
22220000000000002222
22220000000000002222
22220000000000002222
22222210000001222222
22222210000001222222
22222210000001222222
11111110000001111111