00000000000000000000
00000000000000000000
00000000220000000000
22222222222222222222
22222222222222222222
22222222222222222222