00000000000000000000
00000000000000000000
00000000000000000000
11111111111111111111
00000000000000000000
00000000000000000000
00000000000000000000
00000000000000000000
22210000000000001222
22213030300303031222
22213030300303031222
22213030300303031222
22213030300303031222
22213030300303031222
22213030300303031222
22213030300303031222
22213030300303031222
22213030300303031222
22213030300303031222
22213030300303031222
22213030300303031222
22213030300303031222
22213030300303031222
22213030300303031222
22213030300303031222
22211111100111111222
22210000000000001222
22210000000000001222
22210000000000001222
11110000000000001111