00000000000000000000
00000000000000000000
00000000000000000000
00000000000000000000
11111111111111111111
00000000000000000000
00000000000000000000
00222222222222222200
00222222222222222200
00222222222222222200
00000000000000000000
00000000000000000000
00222222222222222200
00222222222222222200
00222222222222222200
00000000000000000000
00000000000000000000
00222222222222222200
00222222222222222200
00222222222222222200
00000000000000000000
00000000000000000000
00111111222211111100
00122222222222222100
00122222222222222100
00122222222222222100
00122222222222222100
00122222222222222100
00122222222222222100
00111111111111111100